
F 255, 0, 244

11111111111111111111111111111111111111111111111111
10000000000000000000000000000000000000000000000001
10S11111111111111111000000001111111111111111111111
10001000000000000001000000001000000000000000000001
11101011111111111101011111101011111111111111111101
10001010000000000001010000101000000000000000000001
10101010111111111111010111101011111111111111111101
10001010000000000000010100001000000000000000000001
11111010111111111111110101010111111111111111111101
10000000101000000000000001000100000000000000000001
10111111101011111111111111111101111111111111111101
10000000001010000000000000000001000000000000000001
11111111111010111111111111111101011111111111111101
10000000000010100000000000000001010000000000000001
10111111111110101111111111111111010111111111111101
10001000000000101000000000000000010100000000000001
11101011111111101011111111111111110101111111111101
10001010000000001010000000000000000101000000000001
10101010111111101010111111111111111101011111111101
10001000100000001000100000000000000001010000000001
11101011101111111111101111111111111111010111111101
10001010001000000000001000000000000000010100000001
10111010101011111111101011111111111111110101111101
10000000101000000000101010000000000000000010000001
11111111111011111111101010111111111111111111111101
10000000000010000000001000100000000000000000000001
10111111111111111111111010101111111111111111111101
10001000000000000000000010100000000000000000000001
11101011111111111111111111101111111111111111111101
10001010000000000000000000001000000000000000000001
10101010111111111111111111101011111111111111111101
10001000100000000000000000001010000000000000000001
11101011101111111111111111111010111111111111111101
10001010001000000000000000000010100000000000000001
10111010101011111111111111111110101111111111111101
10000000101000000000000000000000101000000000000001
11111111111011111111111111111111101011111111111101
10000000001000000000000000000000001010000000000001
11111111111111111111111111111111111111111111111111

