NO ./textures/obstacle1.xpm
SO ./textures/obstacle2.xpm
WE ./textures/obstacle3.xpm
EA ./textures/obstacle4.xpm

F 020,10,0
C 0,200,245

1111111111111111111111111
1000000000110000000000001
10110000011100000000D0001
1001E00000D0000000000000111111111
111111111011000001110000000000001
100000000011000001110111111111111
11110111111111011100000010001
11110111111111011101010010001
11000000110101011100000010001
10000000000000001100D00010001
10000D00000000001101010010001
1100000111010101111101111000111
11110111 1110101 101111010001
11111111 1111111 111111111111
